0200520000000000
0200000000000000
0200510000000000
0200000000000000
0200520000000000
0200000000000000
0200510000000000
0200000000000000
0200510000000000
0200000000000000
0200510000000000
0200000000000000
0200510000000000
0200000000000000
0200520000000000
0200000000000000
0200510000000000
0200000000000000
0200520000000000
0200000000000000
0200520000000000
0200000000000000
0200510000000000
0200000000000000
0200520000000000
0200000000000000
0200520000000000
0200000000000000
0200510000000000
0200000000000000
0200510000000000
0200000000000000
0200520000000000
0200000000000000
0200510000000000
0200000000000000
0200510000000000
0200000000000000
0200520000000000
0200000000000000
0200520000000000
0200000000000000
0200520000000000
0200000000000000
0200520000000000
0200000000000000
0200520000000000
0200000000000000
0200520000000000
0200000000000000
0200520000000000
0200000000000000
0200510000000000
0200000000000000
0200520000000000
0200000000000000
0200510000000000
0200000000000000
0200510000000000
0200000000000000
0200520000000000
0200000000000000
0200520000000000
0200000000000000
0200510000000000
0200000000000000
0200520000000000
0200000000000000
0200510000000000
0200000000000000
0200520000000000
0200000000000000
0200520000000000
0200000000000000
0200510000000000
0200000000000000
0200510000000000
0200000000000000
0200520000000000
0200000000000000
0200520000000000
0200000000000000
0200510000000000
0200000000000000
0200520000000000
0200000000000000
0200520000000000
0200000000000000
0200520000000000
0200000000000000
0200520000000000
0200000000000000
0200510000000000
0200000000000000
0200520000000000
0200000000000000
0200520000000000
0200000000000000
0200510000000000
0200000000000000
0200510000000000
0200000000000000
0200520000000000
0200000000000000
0200520000000000
0200000000000000
0200510000000000
0200000000000000
0200520000000000
0200000000000000
0200510000000000
0200000000000000
0200520000000000
0200000000000000
0200520000000000
0200000000000000
0200510000000000
0200000000000000
0200510000000000
0200000000000000
0200520000000000
0200000000000000
0200520000000000
0200000000000000
0200510000000000
0200000000000000
0200520000000000
0200000000000000
0200520000000000
0200000000000000
0200510000000000
0200000000000000
0200520000000000
0200000000000000
0200520000000000
0200000000000000
0200510000000000
0200000000000000
0200520000000000
0200000000000000
